11111111111111111
101C0100000010001
1P000001001000C11
11100000000010001
1E000010010C00001
11111111111111111