111111111111111111
1C00000000000000E1
111111000000C11001
100000001010000001
1C011010001000C001
110000100100001001
1P01000000010010C1
111111111111111111