11111111111111111
10100100000010001
1P0000010010C0011
11100000000010001
10E00010010000001
11111111111111111
