111111111111111
1C01000E1111111
11110001C111111
1P000C000000011
111111111111111